WWWWWWWWWWWWWWWWWWWWWWWWWWWWWWWWWWWWWWWWWWWWWWWWWWWWWWWWWWWWWWWWWWWWWWWWWWWWWWWW
W                                                                              W
W                                                                              W
W                                                                              W
W                                                                              W
W                                                                              W
W                                                                              W
W                                                                              W
W                                                                              W
W                                                                              W
W                     WWWWWWWWWWWWWWWWWWWWWWWWWWWWWWWWW                        W
W                                                                              W
W                   W                                   W                      W
W                   W                                   W                      W
W                   W                                   W                      W
W                   W                                   W                      W
W                   W                                   W                      W
W                   W                                   W                      W
W                   W                                   W                      W
W                   W                                   W                      W
W                   W                                   W                      W
W                   W                                   W                      W
W                   W                                   W                      W
W                   W                                   W                      W
W                   W        ⇓                   ↑      W                      W
W                   W                                   W                      W
W                   W                                   W                      W
W                   W                                   W                      W
W                   W                                   W                      W
W                   W                                   W                      W
W                   W                                   W                      W
W                   W                                   W                      W
W                   W                                   W                      W
W                   W                                   W                      W
W                   W                                   W                      W
W                   W                                   W                      W
W                   W                                   W                      W
W                   W                                   W                      W
W                   W                                   W                      W
W                                                                              W
W                     WWWWWWWWWWWWWWWWWWWWWWWWWWWWWWWWW                        W
W                                                                              W
W                                                                              W
W                                                                              W
W                                                                              W
W                                                                              W
W                                                                              W
W                                                                              W
W                                                                              W
WWWWWWWWWWWWWWWWWWWWWWWWWWWWWWWWWWWWWWWWWWWWWWWWWWWWWWWWWWWWWWWWWWWWWWWWWWWWWWWW
