WWWWWWWWWWWWWWWWWWWWWWWWWWWWWWWWWWWWWWWWWWWWWWWWWWWWWWWWWWWWWWWWWWWWWWWWWWWWWWWW
W                  W                                                           W
W                  W                                                           W
W                  W                                                           W
W                  W                                                           W
W                  W                                                           W
W                  W                                       ←                   W
W                  W                                                           W
W                  W                                                           W
W                  W                                                           W
W                  W                                                           W
W                  W                    WWWWWWWWWWWWWWWWWWWWWWWWWWWWWWWWWWWWWWWW
W                  W                                                           W
W                  W                                                           W
W                  W                                                           W
W                  W                                                           W
W                  W                                                           W
W                  W                                                           W
W                  W                                                           W
W                  W                                                           W
W                  W                                                           W
W                  W                                                           W
W                  W                                                           W
W                  W                                        W                  W
W                  W                                        W                  W
W                  W                                        W                  W
W                                                           W                  W
W                                                           W                  W
W                                                           W                  W
W                                                           W                  W
W                                                           W                  W
W                                                           W                  W
W                                                           W                  W
W                                                           W                  W
W                                                           W                  W
W                                                           W                  W
W                                                           W                  W
W                                                           W                  W
WWWWWWWWWWWWWWWWWWWWWWWWWWWWWWWWWWWWWWWW                    W                  W
W                                                           W                  W
W                                                           W                  W
W                                                           W                  W
W                  ⇒                                        W                  W
W                                                           W                  W
W                                                           W                  W
W                                                           W                  W
W                                                           W                  W
W                                                           W                  W
W                                                           W                  W
WWWWWWWWWWWWWWWWWWWWWWWWWWWWWWWWWWWWWWWWWWWWWWWWWWWWWWWWWWWWWWWWWWWWWWWWWWWWWWWW
