WWWWWWWWWWWWWWWWWWWWWWWWWWWWWWWWWWWWWWWWWWWWWWWWWWWWWWWWWWWWWWWWWWWWWWWWWWWWWWWW
W        W                   W                   W                   W         W
W                  W                   W                   W                   W
W        W                   W                   W                   W         W
W                  W                   W                   W                   W
W        W                   W                   W                   W         W
W                  W                   W                   W    ↓              W
W        W                   W                   W                   W         W
W                  W                   W                   W                   W
W        W                   W                   W                   W         W
W                  W                   W                   W                   W
W        W                   W                   W                   W         W
W                  W                   W                   W                   W
W        W                   W                   W                   W         W
W                  W                   W                   W                   W
W        W                   W                   W                   W         W
W                  W                   W                   W                   W
W        W                   W                   W                   W         W
W                  W                   W                   W                   W
W        W                   W                   W                   W         W
W                  W                   W                   W                   W
W        W                   W                   W                   W         W
W                  W                   W                   W                   W
W        W                   W                   W                   W         W
W                  W                   W                   W                   W
W        W                   W                   W                   W         W
W                  W                   W                   W                   W
W        W                   W                   W                   W         W
W                  W                   W                   W                   W
W        W                   W                   W                   W         W
W                  W                   W                   W                   W
W        W                   W                   W                   W         W
W                  W                   W                   W                   W
W        W                   W                   W                   W         W
W                  W                   W                   W                   W
W        W                   W                   W                   W         W
W                  W                   W                   W                   W
W        W                   W                   W                   W         W
W                  W                   W                   W                   W
W        W                   W                   W                   W         W
W                  W                   W                   W                   W
W        W                   W                   W                   W         W
W             ⇑    W                   W                   W                   W
W        W                   W                   W                   W         W
W                  W                   W                   W                   W
W        W                   W                   W                   W         W
W                  W                   W                   W                   W
W        W                   W                   W                   W         W
W                  W                   W                   W                   W
WWWWWWWWWWWWWWWWWWWWWWWWWWWWWWWWWWWWWWWWWWWWWWWWWWWWWWWWWWWWWWWWWWWWWWWWWWWWWWWW

